            a: htmlAnchorDirective,
            input: inputDirective,
            textarea: inputDirective,
            form: formDirective,
            script: scriptDirective,
            select: selectDirective,
            style: styleDirective,
            option: optionDirective,
            ngBind: ngBindDirective,
            ngBindHtml: ngBindHtmlDirective,
            ngBindTemplate: ngBindTemplateDirective,
            ngClass: ngClassDirective,
            ngClassEven: ngClassEvenDirective,
            ngClassOdd: ngClassOddDirective,
            ngCloak: ngCloakDirective,
            ngController: ngControllerDirective,
            ngForm: ngFormDirective,
            ngHide: ngHideDirective,
            ngIf: ngIfDirective,
            ngInclude: ngIncludeDirective,
            ngInit: ngInitDirective,
            ngNonBindable: ngNonBindableDirective,
            ngPluralize: ngPluralizeDirective,
            ngRepeat: ngRepeatDirective,
            ngShow: ngShowDirective,
            ngStyle: ngStyleDirective,
            ngSwitch: ngSwitchDirective,
            ngSwitchWhen: ngSwitchWhenDirective,
            ngSwitchDefault: ngSwitchDefaultDirective,
            ngOptions: ngOptionsDirective,
            ngTransclude: ngTranscludeDirective,
            ngModel: ngModelDirective,
            ngList: ngListDirective,
            ngChange: ngChangeDirective,
            pattern: patternDirective,
            ngPattern: patternDirective,
            required: requiredDirective,
            ngRequired: requiredDirective,
            minlength: minlengthDirective,
            ngMinlength: minlengthDirective,
            maxlength: maxlengthDirective,
            ngMaxlength: maxlengthDirective,
            ngValue: ngValueDirective,
            ngModelOptions: ngModelOptionsDirective